    W
    |
 S--+--N
    |
    E

0 1 0 0 0 0 0 1 0 0
0 0 1 0 1 3 1 0 1 0            	(6,2) - CHEST
0 0 0 0 0 1 0 0 0 0
0 1 0 1 0 0 0 0 1 0
1 1 1 1 1 0 1 1 1 1		(4,5) - Forest Entrance
1 1 3 1 1 0 1 1 3 1		(5,2) - Armor shop (5,8) - Weapon shop
0 0 0 0 0 0 0 0 0 0		(5,6) - Town Square
1 1 1 1 1 0 1 1 1 1
1 1 1 1 1 0 1 1 1 1		(8,5) - Catacomb Entrance
0 0 0 0 0 0 0 0 0 0
1 0 0 1 1 0 0 0 1 0
0 0 0 0 0 0 1 0 0 0
0 1 0 0 0 0 1 0 0 0
0 1 0 0 1 0 1 0 0 0
0 1 1 1 1 1 1 0 0 1
0 0 0 0 1 0 0 0 1 1
1 1 0 0 1 1 1 0 0 0
0 0 0 0 0 0 0 0 0 0
1 1 0 0 1 1 0 0 0 0
